###############################
#         *1*2*3*4*5*         #
#         * * * * * *         #
#         * * * * * *         #
#          * * * * *          #
#                             #
#        a*d*o*s*b*f*x*l      #
#         * * * * * *         #
#         * * * * * *         #
#          * * * * *          #
###############################







