###############################
#  * *2       *  ** * *      *#
# # # # #*# # #*# # # # # #*# #
#    * * *** **      *    **  #
# #*# # # # #1# #b#1# # # # #*#
#          *     **   3   * **#
# # #*# # # # # #*#*#*#*# # # #
#   *   3     *   * *x* *     #
# # # # #*# # # # # # #*# #*# #
#   ****         *1           #
# # # # # # # # # #*# # # # #*#
#  ** *   *    2         1    #
###############################