###############################
#    ** **    *   3     5     #
# # # #*# # # # # # # # # # # #
#*     **l* *  *   * b*   *   #
# # # # # #*# # # # # # #*# # #
#*   *s*    *** *   **   1    #
# # # # # # # # # # # # # #*# #
#   *a     *   4    *    **   #
# #*# # #*#*#*#*# # # # # #*# #
#   2    *   * *    *   *     #
#*# # # # # # #  ## # #*# # #*#
# *  5 *o** 4  **d***    2    #
###############################